~~~~~~~~~~~
~~++++~~++~
~++~++~~+~~
~~~~+~~~~~~
~~~~~~~+~~~
~~~~~~+++~~
~~~~~~~~~~~